________________________________
________________________________
________________________X_______
__________X__________XXXX_______
__________X_____________________
__________X_____________________
________________________________
_______________XXXXXX___________
________________________________
__________XXXXX_________________
__________X_____________________
__________X______________X______
__________X______________X______
__________X______________X______
________________________________
_______XXXXXXX__________________
________________________________
________________________________