XXXXXXXXXXXXXXXXXXXXXXXXXXXXXXXX
X______________________________X
X_______________________X______X
X____________________XXXX______X
X______________________________X
X_________X____________________X
X______________________________X
X______________________________X
X______________________________X
X_________X____________________X
X_________X____________________X
X_________X______________X_____X
X_________X______________X_____X
X________________________X_____X
X______________________________X
X______XXXXXXX_________________X
X______________________________X
XXXXXXXXXXXXXXXXXXXXXXXXXXXXXXXX